NO ./textures/eagle.xpm
SO ./textures/purplestone.xpm
WE ./textures/greystone.xpm
EA ./textures/redbrick.xpm
F 220,100,0
C 255,0,0
11111
10001
10001
1W001
11111
